222222222222222
200000000000002
200000010000002
200000330000002
200000440000002
200000043000002
200000000000002
200000000000002
200000000000002
222222222222222
