2222222222222222
2000000000000222
2000000300000022
2000000403001002
2000304440300002
2000044444002002
2000030030002002
2200003303022202
2220000000002002
2222222222222222
