2222222222
2000000002
2022222202
2024404002
2022000202
2000000002
2020200202
2030300302
2000100002
2222222222
