2222222222
2000000002
2000000002
2000403002
2004030012
2000403002
2000000002
2000000002
2000000002
2222222222
